8 8
3 6
1 1
P.......
........
..#..K..
........
...H....
........
..D.....
........